1 1 1 3 1 6 2
4 1 6 1 1 1 1 
1 0 1 1 5 0 1
1 3 1 2 1 1 6
6 7 1 9 3 1 1
1 1 6 1 1 8 7
2 4 1 5 1 6 2